%%%%%%%%
%P     %
% .% . %
%  % o %
% .% . %
%     G%
%%%%%%%%
