%%%%%%%
% P   %
% %%% %
% %. o%
% %%% %
%. G  %
%%%%%%%
